AAMOF	as a matter of fact
ABT	about
ADN	any day now
AFAIC	as far as I'm concerned
AFAICT	as far as I can tell
AFAICS	as far as I can see
AFAIK	as far as I know
AIUI	as I understand it
AKA	also known as
ASAP	as soon as possible
ASL	assistant section leader
ASL	age, sex, location
ASLP	age, sex, location, picture
ASOP	assistant system operator
ATM	at this moment
AWA	as well as
AWHFY	are we having fun yet?
AWOL	absent without leave
AWOL	away without leave
AYOR	at your own risk
B4	before
B4N	bye for now
BAC	back at computer
BC	be cool
BEG	big evil grin
BF	boyfriend
BFN	bye for now
BG	big grin
BION	believe it or not
BM	bite me
BMB	bite my bum
BKA	better known as
BRB	be right back
BRS	big red switch
BS	bull shit
BTDT	been there done that
BTOBS	be there or be square
BTSOOM	beats the shit out of me
BTW	by the way
BYOB	bring your own bottle
CAD	ctrl-alt-delete
CADET	can't add, doesn't even try
CDIWY	couldn't do it without you
CFV	call for votes
CFY	calling for you
CID	crying in disgrace
CMIIW	correct me if I'm wrong
CNP	continue in next post
CRS	can't remember shit
CSG	chuckle snicker grin
CTS	changing the subject
CU	see you
CU2	see you too
CUL	see you later
CUL8R	see you later
CWOT	complete waste of time
CWYL	chat with you later
CYA	see ya
CYAL8R	see ya later
CYO	see you online
DBA	doing business as
DCed	disconnected
DFLA	disenhanced four-letter acronym
DH	darling husband
DIIK	darn if i know
DGA	digital guardian angel
DIY	do it yourself
DQMOT	don't quote me on this
DND	do not disturb
DWAI	don't worry about it
DWIM	do what I mean
DWIMC	do what I mean, correctly
DWISNWID	do what I say, not what I do
DYJHIW	don't you just hate it when...
DYK	do you know
EAK	eating at keyboard
EIE	enough is enough
EG	evil grin
EMFBI	excuse me for butting in
EMFJI	excuse me for jumping in
EMSG	email message
EOD	end of discussion
EOF	end of file
EOL	end of lecture
EOM	end of message
EOS	end of story
EOT	end of thread
ETLA	extended three letter acronym
EYC	excitable, yet calm
F	female
F2F	face to face
FAQ	frequently asked questions
FAWC	for anyone who cares
FBOW	for better or worse
FBTW	fine, be that way
FCFS	first come, first served
FCOL	for crying out loud
FIFO	first in, first out
FISH	first in, still here
FOAF	friend of a friend
FOB	fuck off bitch
FOC	free of charge
FOCL	falling of chair laughing
FOFL	falling on the floor laughing
FOS	freedom of speech
FOTCL	falling of the chair laughing
FTF	face to face
FTTT	from time to time
FU	fucked up
FUBAR	fucked up beyond all recognition
FUCT	failed under continuas testing
FURTB	full up ready to burst (about hard disk drives)
FW	freeware
FWIW	for what it's worth
FYA	for your amusement
FYE	for your entertainment
FYEO	for your eyes only
FYI	for your information
G2B	going to bed
G2G	got to go
G2GGS2D	got to go get something to drink
G2GTAC	got to go take a crap
G2GTAP	got to go take a pee
GA	good afternoon
GAFIA	get away from it all
GAL	get a life
GAS	greetings and salutations
GBH	great big hug
GBR	garbled beyond recovery
GBY	god bless you
GDW	grin, duck and wave
GE	good evening
GF	girlfriend
GFETE	grinning from ear to ear
GFN	gone for now
GFU	good for you
GG	good game
GGU2	good game you two
GIGO	garbage in garbage out
GJ	good job
GL	good luck
GL&GH	good luck and good hunting
GM	good morning / good move / good match
GMAB	give me a break
GMAO	giggling my ass off
GMBO	giggling my butt off
GMTA	great minds think alike
GN	good night
GOK	god only knows
GOWI	get on with it
GPF	general protection fault
GR8	great
GR&D	grinning, running and ducking
GtG	got to go
GTSY	glad to see you
H	hug
HAK	hug and kiss
HAGD	have a good day
HAGN	have a good night
HAGS	have a good summer
HAG1	have a good one
HAHA	having a heart attack
HAND	have a nice day
HB	hug back
HB	hurry back
HDYWTDT	how do you work this dratted thing
HF	have fun
HH	holding hands
HHIS	hanging head in shame
HHJK	ha ha, just kidding
HHOJ	ha ha, only joking
HHOK	ha ha, only kidding
HHOS	ha ha, only seriously
HIH	hope it helps
HILIACACLO	help I lapsed into a coma and can't log off
HIWTH	hate it when that happens
HLM	he loves me
HMS	home made smiley
HMS	hanging my self
HMT	here's my try
HMWK	homework
HOAS	hold on a second
HSIK	how should i know
HTH	hope this helps
HTHBE	hope this has been enlightening
HYLMS	hate you like my sister
IAAA	I am an accountant
IAAL	I am a lawyer
IAC	in any case
IC	I see
IAE	in any event
IAG	I am gay
IBN	I'm bucked naked
ICOCBW	I could of course be wrong
IDC	I don't care
IDGI	I don't get it
IDGW	in a good way
IDI	I doubt it
IDK	I don't know
IDTT	I'll drink to that
IFVB	I feel very bad
IGP	I gotta pee
IGTP	I get the point
IHTFP	I hate this f**king place
IHU	I hate you
IHY	I hate you
II	I'm impressed
IIT	I'm impressed too
IIR	if I recall
IIRC	if I recall correctly
IJWTK	I just want to know
IJWTS	I just want to say
IK	I know
IKWUM	I know what you mean
ILBCNU	I'll be seeing you
ILU	I love you
ILY	I love you
ILYFAE	I love you forever and ever
IMAO	in my arrogant opinion
IMFAO	in my f***ing arrogant opinion
IMBO	in my bloody opinion
IMCO	in my considered opinion
IME	in my experience
IMHO	in my humble opinion
IMNSHO	in my, not so humble opinion
IMO	in my opinion
IMOBO	in my own biased opinion
IMPOV	in my point of view
IMP	I might be pregnant
INAL	I'm not a lawyer
INPO	in no particular order
IOIT	I'm on Irish Time
IOW	in other words
IRL	in real life
IRMFI	I reply merely for information
IRSTBO	it really sucks the big one
IS	I'm sorry
ISEN	internet search environment number
ISTM	it seems to me
ISTR	I seem to recall
ISWYM	I see what you mean
ITFA	in the final analysis
ITRO	in the reality of
ITRW	in the real world
ITSFWI	if the shoe fits, wear it
IVL	in virtual live
IWALY	I will always love you
IWBNI	it would be nice if
IYKWIM	if you know what I mean
IYSWIM	if you see what I mean
JAM	just a minute
JAS	just a second
JASE	just another system error
JAWS	just another windows shell
JIC	just in case
JJWY	just joking with you
JK	just kidding
JMHO	just my humble opinion
JMO	just my opinion
JP	just playing
JTLYK	just to let you know
JW	just wondering
K	OK
K	kiss
KHYF	know how you feel
KB	kiss back
KISS	keep it simple stupid
KIT	keep in touch
KMA	kiss my ass
KMB	kiss my butt
KMSMA	kiss my shiny metal ass
KOTC	kiss on the cheek
KOTL	kiss on the lips
KUTGW	keep up the good work
KWIM	know what I mean?
L8R	later
L8R G8R	later gator
LAB	life's a bitch
LAM	leave a message
LBR	little boys room
LD	long distance
LG	lovely greetings
LIMH	laughing in my head
LGR	little girls room
LHM	Lord help me
LHU	Lord help us
LNK	love and kisses
LMA	leave me alone
LMABO	laughing my ass back on
LMAO	laughing my ass off
MBO	laughing my butt off
LMHO	laughing my head off
LMFAO	laughing my fat ass off
LMK	let me know
LOL	laughing out loud
LOLA	laughing out loud again
LOML	light of my life (or love of my life)
LOMLILY	light of my life, I love you
LOOL	laughing out outrageously loud
LSHIPMP	laughing so hard I pissed my pants
LSHMBB	laughing so hard my belly is bouncing
LSHMBH	laughing so hard my belly hurts
LTNS	long time no see
LTR	long term relationship
LTS	laughing to self
LULAS	love you like a sister
LUWAMH	love you with all my heart
LY	love ya
LYK	let you know
LYL	love ya lots
LYLAB	love ya like a brother
LYLAS	love ya like a sister
M	male
MB	maybe
MYOB	mind your own business
M8	mate
N2M	not too much
NE1	anyone
NETUA	nobody ever tells us anything
NFI	no fucking idea
NL	not likely
NM	never mind 
NMH	not much here
NMJC	nothing much, just chillin
NOM	no offense meant
NOYB	none of your business
NOYFB	none of your fucking business
NP	no problem
NPS	no problem sweet
NTA	non-technical acronym
NS	no shit
NVM	nevermind
OBTW	oh, by the way
OF	on fire
OFIS	on floor with stitches
OMG	oh my god
OOC	out of character
OT	Off topic
OTOH	on the other hand
OTTOMH	off the top of my head
PAH	parents at home
PAW	parents are watching
PDS	please don't shoot
PEBCAK	problem exists between chair and keyboard
PIZ	parents in room
PLZ	please
PM	private message
PMJI	pardon my jumping in (Another way for PMFJI)
PMFJI	pardon me for jumping in
PMP	peed my pants
POAHF	put on a happy face
POOF	I have left the chat
POTB	pats on the back
POS	parents over shoulder
PPL	people
PS	post script
PSA	public show of affection
Q4U	question for you
QSL	reply
QSO	conversation
QT	cutie
RME	rolling my eyses
ROFL	rolling on floor laughing
ROFLAPMP	rolling on floor laughing and peed my pants
ROFLMAO	rolling on floor laughing my ass off
ROFLOLAY	rolling on floor laughing out loud at you
ROFLOLUTS	rolling on floor laughing out loud unable to speak
ROTFL	rolling on the floor laughing
RVD	really very dumb
RUTTM	are you talking to me
RTF	read the FAQ
RTFM	read the fucking manual
RTSM	read the stupid manual
S2R	send to receive
SAMAGAL	stop annoying me and get a live
SCNR	sorry, could not resist
SETE	smiling ear to ear
SH	so hot
SH	same here
SHICPMP	so happy I could piss my pants
SHID	slaps head in disgust
SHMILY	see how much I love you
SNAFU	situation normal, all F***ed up
SO	significant other
SOHF	sense of humor failure
SPAM	stupid persons' advertisement
SRY	sorry
SSDD	same shit different day
STBY	sucks to be you
STFU	shut the fuck up
STW	search the web
SWAK	sealed with a kiss
SWALK	sweet, with all love, kisses
SWL	screaming with laughter
SIM	shit, it's Monday
SITWB	sorry, in the wrong box
SYS	see you soon
SYSOP	system operator
TA	thanks again
TCO	taken care of
TGIF	thank god its Friday
THTH	to hot to handle
THX	thanks
TIA	thanks in advance
TIIC	the idiots in charge
TLA	three-letter acronym
TMA	take my advice
TMI	to much information
TMS	to much showing
TNX	thanks
TOH	to other half
TOY	thinking of you
TPTB	the powers that be
TSDMC	tears streaming down my cheeks
TT2T	to tired to talk
TTT	thought that, too
TTUL	talk to you later
TTYIAM	talk to you in a minute
TTYL	talk to you later
TTYLMF	talk to you later my friend
TU	thank you
TWMA	till we meet again
TX	thanx
TY	thank you
TYVM	thank you very much
U2	you too
UAPITA	you're a pain in the ass
UR	your
UW	you're welcom
VBG	very big grin
VBS	very big smile
W8	wait
W8AM	wait a minute
WAY	what about you
WAY	who are you
WB	welcome back
WBS	write back soon
WDHLM	why doesn't he love me
WDYWTTA	What Do You Want To Talk About
WE	whatever
WFM	works for me
WNDITWB	we never did it this way before
WP	wrong person
WRT	with respect to
WTF	what the fuck
WTG	way to go
WTH	what the heck
WTMI	way to much information
WUD	what's up dog
WUF	where are you from
WUWT	whats up with that
WYMM	will you marry me
WYSIWYG	what you see is what you get
XTLA	extended three letter acronym
Y2K	you're too kind
YATB	you are the best
YBS	you'll be sorry
YG	young gentleman
YKYWTKM	you know you want to kiss me
YL	young lady
YM	you mean
YM	young man
YMMD	you've made my day
YMMV	your mileage may vary
YVM	you're very welcom
YW	you're welcome
YWIA	you're welcome in advance
YWTHM	you want to hug me
YWTLM	you want to love me
YWTKM	you want to kiss me
YOYO	you're on your own
YY4U	two wise for you